א| בגדהו¸זחטיךכלםמןנסעףפץצקרשת‎‏
ב| אגדהו¸זחטיךכלםמןנסעףפץצקרשת‎‏
ג| אבדהו¸זחטיךכלםמןנסעףפץצקרשת‎‏
ד| אבגהו¸זחטיךכלםמןנסעףפץצקרשת‎‏
ה| אבגדו¸זחטיךכלםמןנסעףפץצקרשת‎‏
ו| אבגדה¸זחטיךכלםמןנסעףפץצקרשת‎‏
¸| אבגדהוזחטיךכלםמןנסעףפץצקרשת‎‏
ז| אבגדהו¸חטיךכלםמןנסעףפץצקרשת‎‏
ח| אבגדהו¸זטיךכלםמןנסעףפץצקרשת‎‏
ט| אבגדהו¸זחיךכלםמןנסעףפץצקרשת‎‏
י| אבגדהו¸זחטךכלםמןנסעףפץצקרשת‎‏
ך| אבגדהו¸זחטיכלםמןנסעףפץצקרשת‎‏
כ| אבגדהו¸זחטיךלםמןנסעףפץצקרשת‎‏
ל| אבגדהו¸זחטיךכםמןנסעףפץצקרשת‎‏
ם| אבגדהו¸זחטיךכלמןנסעףפץצקרשת‎‏
מ| אבגדהו¸זחטיךכלםןנסעףפץצקרשת‎‏
ן| אבגדהו¸זחטיךכלםמנסעףפץצקרשת‎‏
נ| אבגדהו¸זחטיךכלםמןסעףפץצקרשת‎‏
ס| אבגדהו¸זחטיךכלםמןנעףפץצקרשת‎‏
ע| אבגדהו¸זחטיךכלםמןנסףפץצקרשת‎‏
ף| אבגדהו¸זחטיךכלםמןנסעפץצקרשת‎‏
פ| אבגדהו¸זחטיךכלםמןנסעףץצקרשת‎‏
ץ| אבגדהו¸זחטיךכלםמןנסעףפצקרשת‎‏
צ| אבגדהו¸זחטיךכלםמןנסעףפץקרשת‎‏
ק| אבגדהו¸זחטיךכלםמןנסעףפץצרשת‎‏
ר| אבגדהו¸זחטיךכלםמןנסעףפץצקת‎‏
ש| אבגדהו¸זחטיךכלםמןנסעףפץצקת‎‏
ת| או¸טימף‎‏
| בגדהזחיךכלםןנסעפץצקרשת
| או¸טימף‎‏
‎| אבגדהו¸זחטיךכלםמןנסעףפץצקרשת‏
‏| אבגדהו¸זחטיךכלםמןנסעףפץצקרשת‎
| אבגדהו¸זחטיךכלםמןנסעףפץצקרשת‎‏
FL| אבגדהו¸זחטיךכלםמןנסעףפץצקרש‎‏